states,old_application,new_application,total_application,paid,rejected,pending
Delhi,2000,500,2500,500,300,1700
M.P.,3000,667,3667,700,400,2567
U.P.,5667,889,6556,567,500,5489
A.P.,8976,456,9432,789,456,8187
Karnataka,5678,234,5912,345,389,5178
Tamil Nadu,2345,897,3242,456,567,2219
Gujarat,1234,567,1801,897,890,14
J&K,789,345,1134,123,789,222
Orissa,698,156,854,456,200,198
Rajasthan,8000,537,8537,678,2000,5859
